WWWWWWWWWWWWWWWWWWWWWWWW
WPK                    W
WWWWWW                 W
WE                     W
WE                     W
WE                     W
WE                     W
WE                     W
WE                     W
WE                     W
WE                     W
WE                     W
WE                     W
WE                     W
WE                     W
WE                     W
WE                     W
WE                     W
WWWWWWWWWWWWWWWWWWWWWWWW