WWWWWWWWWWWWWWWWWWWWWWWW
WPK                    W
WWWWWW            N    W
WE                     W
WE                     W
WE                     W
WE    N                W
WE                     W
WE                     W
WE             WWWWWWWWW
WE                    EW
WE                    EW
WE           N        EW
WE                    EW
WE                    EW
WE                    EW
WE     N              EW
WE                    EW
WWWWWWWWWWWWWWWWWWWWWWWW