WWWWWWWWWWWWWWWWWWWWWWWW
WPK                    W
WWWWWW                 W
WE                     W
WE                     W
WE                     W
WE    N                W
WE                     W
WE                     W
WE             WWWWWWWWW
WE     K              EW
WE                    EW
WE                    EW
WE                    EW
WE                    EW
WE                 K  EW
WE     N              EW
WE                    EW
WWWWWWWWWWWWWWWWWWWWWWWW