WWWWWWWWWWWWWWWWWWWWWWWW
WPK                    W
W                      W
W               K      W
W                      W
WWWWWWWWW              W
W                      W
W   N                  W
W                      W
W              WWWWWWWWW
W      K               W
W                  N   W
W                      W
WWWWWWWWWWW            W
W                      W
W                  K   W
WEE    N               W
WEE                    W
WWWWWWWWWWWWWWWWWWWWWWWW