WWWWWWWWWWWWWWWWWWWWWWWW
WP                     W
W        KKKKK         W
W       K     K        W
W      K       K       W
W      K  WWWWWWW      W
W     K  W       W     W
W    KK  W       W     W
W   K K  W       W     W
W   K K   WWWWWWW      W
W   K K        K       W
W   K K        K       W
W    KK        K       W
W     K   KK   K       W
W     K  K  K  K       W
W     K  K  K  K       W
W      KKK  KKK        W
W                     EW
WWWWWWWWWWWWWWWWWWWWWWWW
