WWWWWWWWWWWWWWWWWWWWWWWW
WP   WK          WK    W
WWWW WWW    W    WWWWW W
W KW WWWW   W    WN    W
W  W W      W    W     W
W  W WWWW   WN   W     W
W  W W    WWWWW  W     W
W           W          W
WWWWWW   WWWWWWWWWWWW  W
W   KW   WNW           W
W  WWN   W W WWWWW     W
W    W  WW W     K  W  W
W    W     W KNE W  W  W
W       WW W     W  WN W
W       W  WWWWWWW  WWWW
WN      WWNWN          W
W WWWWWWWWWWWWWWWWWW WWW
W                     NW
WWWWWWWWWWWWWWWWWWWWWWWW