WWWWWWWWWWWWWWWWWWWWWWWW
WP                     W
W    NNN       NNN     W
W    NKN       NKN     W
W    NNN       NNN     W
W                      W
W    NNN       NNN     W
W    NKN       NKN     W
W    NNN       NNN     W
W                      W
WWWWWWWWWWWWWWWWWWWWW WW
W                     NW
WW WWWWWWWWWWWWWWWWWWWWW
WN                     W
WWWWWWWWWWWWWWWWWWWWW WW
W                     NW
WW WWWWWWWWWWWWWWWWWWWWW
WN                    EW
WWWWWWWWWWWWWWWWWWWWWWWW